WWWWWWWWWWWWWWWWWWWWWWWWWWWWWWWWWWWWWWWWWWWWWWWWWWWW
WIIIIIIIIIIIIIIIMMMMMMMMMMMMMMMMMMIIIIIIIIIIIIIIIIIW
WIIIIIIIIIIIIIIIIMMMMMMMMMMMMMMMMMMIIIIIIIIIIIIIIIIW
WIIIIIIIIIIIIIIIIIMMMMMMMMMMMMMMMMMIIIIIIIIIIIIIIIIW
WIIIIIIIIIIIIIIIIIMMMMMMMMMMMMMMMMGGGGGGGGGGGGGGGGGW
WIIIIIIIIIIIIIIIIMMMMMMMMMMMMMMMMGGGGGGGGGGGGGGGGGGW
WIIIIIIIIIIIIIIIIMMMMMMMMMMMMMMMGGGGGGGGGGGGGGGGGGGW
WIIIIIIIIIIIIIIIIMMMMMMMMMMMGGGGGGGGGGGGGGGGGGGGGGGW
WIIIIIIIIIIIIIIIIGGGGGGGGGGGGGGGGGGGGGGGGGGGGGGGGGGW
WGGGGGGGGGGGGGGGGGGGGGGGGGGGGGGGGGGGGGGGGGGGGGGGGGGW
WGGGGGGGGGGGGGGGGGGGGGGGGGGGGGGGGGGGGGGGGGGGGGGGGGGW
WGGGGGGGGGGGGGGGGGGGGGGGGGGGGGGGGGGGGGGGGGGGGGGGGGGW
WGGGGGGGGGGGGGGGGGGGGGGGGGGGGGGGGGGGGGGGGGGGGGGGGGGW
WGGGGGGGGGGGGGGGGGGGGGGGGGGGGGGGGGGGGFFFFFFFFFFFFFFW
WGGGGGGGGGGGGGGGGGGGGGGGGGGGGGGGGGFFFFFFFFFFFFFFFFFW
WGGGGGGGGGGGGGGGGGGGGGGGGGGGGGGGGFFFFFFFFFFFFFFFFFFW
WGGGGGGGGGGGGGGGGGGGGGGGGGGGGGGGFFFFFFFFFFFFFFFFFFFW
WGGGGGGGGGGGGGGGGGGGGGGGGGGGGGGGGFFFFFFFFFFFFFFFFFFW
WGGGGGGGGGGGGGGGGGGGGGGGGGGGGGGGFFFFFFFFFFFFFFFFFFFW
WGGGGGGGGGGGGGGGGGGGGGGGGGGGGGGGFFFFFFFFFFFFFFFFFFFW
WGGGGGGGGGGGGGGGGGGGGGGGGGGGGGGGGGGGFFFFFFFFFFFFFFFW
WGGGGGGGGGGGGGGGGGGGGGGGGGGGGGGGGGGGGGGGGGGGGGGGGGGW
WGGGGGGGGGGGGGGGGGGGGGGGGGGGGGGGGGGGGGGGGGGGGGGGGGGW
WGGGGGGGGGGGGGGGGGGGGGGGGGGGGGGGGGGGGGGGGGGGGGGGGGGW
WGGGGGGGGGGGGGGGGGGGGGGGGGGGGGGGGGGGGGGGGGGGGGGGGGGW
WGGGGGGGGGGGGGGGGGGGGGGGGGGGGGGGGGGGGGGGGGGGGGGGGGGW
WGGGGGGGGGGGGGGGGGGGGGGGGGGGGGGGGGGGGGGGGGGGGGGGGGGW
WGGGGGGGGGGGGGGGGGGGGGGGGGGGGGGGGGGGGGGGGGGGGGGGGGGW
WGGGGGGGGGGGGGGGGGGGGGGGGGGGGGGGGGGGGGGGGGGGGGGGGGGW
WGGGGGGGGGGGGGGGGGGGGGGGGGGGGGGGGGGGGGGGGGGGGGGGGGGW
WGGGGGGGGGGSSSSSSSSSSSGGGGGGGGGGGGGGGGGGGGGGGGGGGGGW
WGGGGGGGGSSSSSSSSSSSSSSSGGGGGGGGGGGGGGGGGGGGGGGGGGGW
WGGGGGGGSSSSSSSSSSSSSSSSSGGGGGGGGGGGGGGGGGGGGGGGGGGW
WGGGGGGGSSSSSSSSSSSSSSSSSGGGGGGGGGGGGGGGGGGGGGGGGGGW
WGGGGGGGSSSSSSSSSSSSSSSSSGGGGGGGGGGGGGGGGGGGGGGGGGGW
WGGGGGGGSSSSSSSSSSSSSSSSSGGGGGGGGGGGGGGGGGGGGGGGGGGW
WGGGGGGGGSSSSSSSSSSSSSSSGGGGGGGGGGGGGGGGGGGGGGGGGGGW
WGGGGGGGGGGSSSSSSSSSSSGGGGGGGGGGGGGGGGGGGGGGGGGGGGGW
WGGGGGGGGGGGGGGGGGGGGGGGGGGGGGGGGGGGGGGGGGGGGGGGGGGW
WGGGGGGGGGGGGGGGGGGGGGGGGGGGGGGGGGGGGGGGGGGGGGGGGGGW
WGGGGGGGGGGGGGGGGGGGGGGGGGGGGGGGGGGGGGGGGGGGGGGGGGGW
WGGGGGGGGGGGGGGGGGGGGGGGGGGGGGGGGGGGGGGGGGGGGGGGGGGW
WGGGGGGGGGGGGGGGGGGGGGGGGGGGGGGGGGGGGGGGGGGGGGGGGGGW
WGGGGGGGGGGGGGGGGGGGGGGGGGGGGGGGGGGGGGGGGGGGGGGGGGGW
WGGGGGGGGGGGGGGGGGGGGGGGGGGGGGGGGGGGGGGGGGGGGGGGGGGW
WGGGGGGGGGGGGGGGGGGGGGGGGGGGGGGGGGGGGGGGGGGGGGGGGGGW
WGGGGGGGGGGGGGGGGGGGGGGGGGGGGGGGGGGGGGGGGGGGGGGGGGGW
WGGGGGGGGGGGGGGGGGGGGGGGGGGGGDDDDDDDDDDDDDDDDDDDDDDW
WGGGGGGGGGGGGGGGGGGGGGGGGGGGGDDDDDDDDDDDDDDDDDDDDDDW
WGGGGGGGGGGGGGGGGGGGGGGGGGGGDDDDDDDDDDDDDDDDDDDDDDDW
WWWWWWWWWWWWWWWWWWWWWWWWWWWWWWWWWWWWWWWWWWWWWWWWWWWW
